Head	Neck
Neck	SpineShoulder
SpineShoulder	SpineMid
SpineMid	SpineBase
SpineShoulder	ShoulderRight
ShoulderRight	ElbowRight
ElbowRight	WristRight
WristRight	HandRight
SpineShoulder	ShoulderLeft
ShoulderLeft	ElbowLeft
ElbowLeft	WristLeft
WristLeft	HandLeft
SpineBase	HipRight
HipRight	KneeRight
KneeRight	AnkleRight
AnkleRight	FootRight
SpineBase	HipLeft
HipLeft	KneeLeft
KneeLeft	AnkleLeft
AnkleLeft	FootLeft