HeadTop	HeadTop
HeadFront	HeadFront
HeadR	HeadRight
HeadL	HeadLeft
SpineTop	SpineTop
RShoulderTop	ShoulderTopRight
RShoulderBack	ShoulderBackRight
RArm	ArmRight
BackR	BackRight
RElbowOut	ElbowRight
RWristOut	WristOutRight
RWristIn	WristInRight
RHandOut	HandOutRight
RHandIn	HandInRight
LShoulderTop	ShoulderTopLeft
LShoulderBack	ShoulderBackLeft
Chest	Chest
LArm	ArmLeft
BackL	BackLeft
LElbowOut	ElbowLeft
LWristOut	WristOutLeft
LWristIn	WristInLeft
LHandOut	HandOutLeft
LHandIn	HandInLeft
WaistRBack	WaistBackRight
WaistRFront	WaistFrontRight
RThigh	ThighRight
RKneeOut	KneeRight
RShin	ShinRight
RAnkleOut	AnkleRight
RHeelBack	HeelRight
RForefootOut	ForefootOutRight
RForefootIn	ForefootInRight
RToeTip	ToetipRight
WaistLBack	WaistBackLeft
WaistLFront	WaistFrontLeft
LThigh	ThighLeft
LKneeOut	KneeLeft
LShin	ShinLeft
LAnkleOut	AnkleLeft
LHeelBack	HeelLeft
LForefootOut	ForefootOutLeft
LForefootIn	ForefootInLeft
LToeTip	ToetipLeft